type octile
height 22
width 22
map
TTTTTTTTTTTTTTTTTTTTTT
T..T..T..T..T..T..T..T
T..T..T..T..T..T..T..T
TTTT..TTTT..T..T..T..T
T..T..T..T..T..T..T..T
T..T..T..T..T..T..T..T
T..TTTT..TTTT..TTTT..T
T..T..T..T..T..T..T..T
T..T..T..T..T..T..T..T
T..T..TTTT..T..TTTT..T
T..T..T..T..T..T..T..T
T..T..T..T..T..T..T..T
T..T..T..TTTT..T..T..T
T..T..T..T..T..T..T..T
T..T..T..T..T..T..T..T
TTTT..TTTT..TTTT..T..T
T..T..T..T..T..T..T..T
T..T..T..T..T..T..T..T
T..T..T..TTTT..T..T..T
T..T..T..T..T..T..T..T
T..T..T..T..T..T..T..T
TTTTTTTTTTTTTTTTTTTTT
