type octile
height 10
width 10
map
TTTTTTTTTT
T........T
T........T
S..TTTT..T
T..T..T..F
T..T..T..T
TTTT..T..T
T........T
T........T
TTTTTTTTTT
