type octile
height 10
width 10
map
TTTTTTTTTT
T........T
T........T
T..TTTTTTT
T..T.....T
T..T.....T
S..TTTT..T
T........T
T........F
TTTTTTTTTT
