type octile
height 22
width 22
map
TTTTTTTTTTTTTTTTTTTTTT
T....................T
T....................T
TTTTTTT..TTTTTTTTTT..T
T........T........T..T
T........T........T..T
S..TTTT..TTTTTTT..T..T
T.....T.....T.....T..T
T.....T.....T.....T..T
TTTT..TTTT..T..TTTT..T
T.....T.....T..T.....F
T.....T.....T..T.....T
T..TTTTTTT..T..TTTT..T
T..T.....T..T.....T..T
T..T.....T..T.....T..T
T..T..T..TTTTTTT..T..T
T.....T...........T..T
T.....T...........T..T
TTTTTTTTTTTTTTTTTTT..T
T....................T
T....................T
TTTTTTTTTTTTTTTTTTTTTT
