type octile
height 16
width 16
map
TTTTTTTTTTTTTTTT
T...........T..T
T...........T..T
TTTTTTT..T..T..T
T.....T..T.....T
T.....T..T.....F
S..T..T..TTTT..T
T..T.....T..T..T
T..T.....T..T..T
TTTTTTTTTT..T..T
T.....T........T
T.....T........T
T..TTTT..TTTTTTT
T..............T
T..............T
TTTTTTTTTTTTTTTT
