type octile
height 22
width 22
map
TTTTTTTTTTTTTTTTTTTTTT
T..............T.....T
T..............T.....T
T..TTTT..TTTT..T..T..T
T..T.....T.....T..T..T
T..T.....T.....T..T..T
TTTT..TTTT..TTTTTTT..T
T.....T..T.....T.....T
T.....T..T.....T.....T
T..TTTT..TTTT..T..TTTT
T..T...........T..T..T
T..T...........T..T..F
T..TTTTTTTTTTTTT..T..T
T..T.....T........T..T
T..T.....T........T..T
S..T..T..T..TTTTTTT..T
T.....T..T..T........T
T.....T..T..T........T
T..TTTT..T..T..TTTT..T
T.....T........T.....T
T.....T........T.....T
TTTTTTTTTTTTTTTTTTTTTT
