type octile
height 22
width 22
map
TTTTTTTTTTTTTTTTTTTTTT
T....................T
T....................T
T..TTTTTTTTTTTTT..T..T
T.....T........T..T..T
T.....T........T..T..F
TTTT..T..TTTT..T..TTTT
T..T..T.....T..T.....T
T..T..T.....T..T.....T
S..T..TTTT..T..T..T..T
T.....T.....T..T..T..T
T.....T.....T..T..T..T
T..TTTTTTTTTT..TTTT..T
T..T...........T.....T
T..T...........T.....T
T..T..TTTTTTTTTT..TTTT
T..T..............T..T
T..T..............T..T
T..TTTTTTTTTTTTTTTT..T
T....................T
T....................T
TTTTTTTTTTTTTTTTTTTTTT
